0,0,0,0,0,0,0,0,0,0,0,0,0,0,0,0,1,0,0,0,0,0,1,2,0,1,0,0,0,0,0,0,0,0,0,0,0,0,0,0,0,0,0,0,0,0,0,0,1,2,0,0,0,0,0,0,0,0,0,1
0,0,1,2,2,0,0,0,0,0,0,0,0,1,0,0,0,0,0,0,0,0,1,2,0,0,1,2,0,0,0,0,0,0,0,0,0,0,0,1,2,0,0,0,0,0,0,0,0,0,0,0,0,0,0,0,0,0,0,0
3,4,5,3,3,3,3,3,3,4,3,3,3,3,4,3,4,3,3,4,3,3,3,4,5,3,3,3,3,4,5,3,3,3,3,3,4,3,4,5,3,4,5,3,3,3,3,3,3,3,3,3,3,3,3,3,3,3,4,5
3,3,3,3,3,4,3,3,3,3,3,3,3,3,3,4,3,3,3,3,3,4,3,3,3,3,3,4,3,3,3,3,3,3,3,3,3,4,3,3,3,4,5,5,3,3,3,3,4,5,3,3,3,3,3,3,3,3,4,5
6,7,8,6,6,6,6,6,6,6,6,6,6,6,6,6,6,6,6,6,6,6,6,6,7,8,6,7,8,6,7,6,6,6,6,7,8,6,6,6,6,6,6,6,6,7,8,6,6,7,6,6,6,6,6,6,6,6,7,8
6,6,6,6,6,6,7,8,6,6,7,8,6,6,6,6,6,6,6,6,7,6,6,6,7,8,6,6,6,6,6,6,6,6,6,6,6,6,6,6,7,6,6,6,6,7,8,6,6,6,7,8,8,6,6,7,8,6,7,8
9,10,11,9,9,10,11,9,9,9,9,9,9,9,9,9,9,9,9,10,11,9,9,9,9,9,10,11,9,9,9,9,9,9,9,9,9,9,9,9,9,9,9,9,9,9,9,9,9,9,9,9,10,11,11,11,11,11,9,10
9,10,11,9,9,10,11,9,9,9,9,9,10,11,11,11,11,11,9,9,9,10,11,11,9,9,9,9,9,9,9,9,9,10,11,9,9,9,9,9,9,9,9,9,9,9,9,9,10,11,11,9,9,9,10,11,10,11,11,11
9,9,10,9,9,10,11,9,10,9,9,10,11,9,9,9,10,9,10,11,11,11,11,11,11,11,11,11,11,11,11,11,9,9,9,9,10,11,9,9,9,9,9,9,9,9,9,9,9,9,10,11,11,11,11,11,11,11,9,10
9,10,9,9,9,10,9,9,9,9,9,10,11,9,9,9,10,11,11,11,11,9,9,9,9,9,9,9,9,9,10,11,11,11,9,9,9,9,9,9,9,9,9,9,9,9,9,9,9,9,9,9,9,9,9,9,9,9,9,9
9,10,9,10,9,10,11,9,9,9,9,9,10,11,11,11,9,9,9,9,9,9,9,10,11,9,10,11,9,9,9,9,9,9,9,9,9,9,9,9,9,9,9,9,9,9,9,9,9,9,9,9,9,9,9,9,9,9,9,9
